Development - разработка
Hence - следовательно
devoted - посвященный
notable - заметный
outcome - результат
to cover - охватывать 
control-flow - поток управления
to defer - отложить
appropriate point - подходящий момент 
evaluation - оценка
staging - ступенчатый
obtain - получать 
delimit - разграничивать 
layered - слоистый
overwhelmed - ошеломленный/подавленный/сокрушенный
insurance - страховка
malfunctioned - неисправно работать/сломанный...
to blamed - виноват
disproportionately - непропорционально 
to assume - предполагать
to assume ever more importance - приобретать все больше значения
to amplify - усиливать
to break down - ломаться
to be laid off - быть уволенным
a matter of life and death - вопрос жизни и смерти
the means - средства
people whith the means - люди со средствами 
to contribute - способствовать
to draw unemployment benefits - получать пособие по безработице
crack - трещина
evident - очевидный 
to respond - откликнуться/реагировать
laying off - увольнение
file for unemployment - подать заявление на пособие по безработице
as the smth unfolded - по мере того, как что-то разворачивалось
aged - пристарелый
obsolete - устаревший 
to originate - проитсходить/роджаться/возникать
funds - фонды/денежные средства 
deluge - потоп наводнение
havoc - опустошение
governor - губернатор
to wreak on - наносить ущерб 
to plead - умолять
scapegoat - козел отпущения
remarkable - замечательный/поразительный/прекрасный
globe - земной шар
roughly - грубо/примерно/ориетнировчно
robust - крепкий 
to convene - собираться
to evolve - развиваться/эволюционировать
intended - предназначенный 
